11111111111111111
1P000C0e000000001
100e000e0e0000001
1000000e00000e001
10000e0e000000001
1C00000C000e000E1
11111111111111111
